BAAAAAABAAABAAAADAAAACAAAAAAAAAABBAAAAAADAAAAAAABAAAAAABAAAABAAAAAAAACAAAAAAAAABAAAAAAAAAAABBAAAAAAAAAAABAAAAAAAAACAAAAAAAABAAAAAAAAAADAAAAABAAAAAAAAABAAAAAAAAAAAAAAAAAAABAAAAAAAADAABF
BBAAAAABBAAAAAAAAAAAAAABBBACAAAAAAABAAAAAAAAAAAAACABAAAAAAAAAAAABAAAAAAAAAADAAAAACAAABABAAABAAAAAAABAAAAAAAAABAAABBAAAAAAAAAAABAAAAAAAAAAAAAAAAAABAAAAAACAAAAAAAAABAAAAAAAAAAAAAAABAAAAF
BAAAEAAAAABAAAAAABAAAAAAAAAAAABAAAAAAACABAAAAAAAAAAAAAAAABAABBBAAAAAAAABAAAAAAAAAAAAAAAAABAAABAAAAAACAAAAAAAAAAAAAAAAAABAAAAADAAAAAAAAAABAAAAAAAAAAAAAAAAAAAABAAAAAAAAAAAAAAAAABAAAAAAAF
BABAAAAAAAAABAAAAAAAAAABAAACAAAAAAAAAAAAABAAADAAAAAABAAAAAAAAAAAACAAAAAAADAAAAAAAAABAACAAAAAAAAAAAABAAAAAAAAAABAAAAAAAAAAAAAAAAAAAABAAAAAAAAABBBAAAAABAAAAAAAAAAAAAABAAAAAAAAAAAAAAAAAAF
BDAAAAAABACAAAAAABAAAAAAABAAAAAAACAAAABAAAAABAAAABAAAAACAAAAAAAABAABAAAAAAAAAAABAAAAAAAAABAAAAADAAAAAAAAAAAACAAAAAABAAAAAAAABAAAAAAAAAAAACAAAAABAAAAAAAAAAADAAAAAABAAAAAAAABBAAAABABAABF
