AAAAAABAAABAAAADAAAACAAAAAAAAAABBAAAAAADAAAAAAABAAAAAABAAAABAAAAAAAACAAAAAAAAABAAAAAAAAAAABBAAAAAAAAAAABAAAAAAAAACAAAAAAAABAAAAAAAAAADAAAAABAAAAAAAAABAAAAAAAAAAAAAAAAAAABAAAAAAAADAABF
BAAAAABBAAAAAAAAAAAAAABBBACAAAAAAABAAAAAAAAAAAAACABAAAAAAAAAAAABAAAAAAAAAADAAAAACAAABABAAABAAAAAAABAAAAAAAAABAAABBAAAAAAAAAAABAAAAAAAAAAAAAAAAAABAAAAAACAAAAAAAAABAAAAAAAAAAAAAAABAAAAF
AAAEAAAAABAAAAAABAAAAAAAAAAAABAAAAAAACABAAAAAAAAAAAAAAAABAABBBAAAAAAAABAAAAAAAAAAAAAAAAABAAABAAAAAACAAAAAAAAAAAAAAAAAABAAAAADAAAAAAAAAABAAAAAAAAAAAAAAAAAAAABAAAAAAAAAAAAAAAAABAAAAAAAF
ABAAAAAAAAABAAAAAAAAAABAAACAAAAAAAAAAAAABAAADAAAAAABAAAAAAAAAAAACAAAAAAADAAAAAAAAABAACAAAAAAAAAAAABAAAAAAAAAABAAAAAAAAAAAAAAAAAAAABAAAAAAAAABBBAAAAABAAAAAAAAAAAAAABAAAAAAAAAAAAAAAAAAF
DAAAAAABACAAAAAABAAAAAAABAAAAAAACAAAABAAAAABAAAABAAAAACAAAAAAAABAABAAAAAAAAAAABAAAAAAAAABAAAAADAAAAAAAAAAAACAAAAAABAAAAAAAABAAAAAAAAAAAACAAAAABAAAAAAAAAAADAAAAAABAAAAAAAABBAAAABABAABF
