AAAAAABAAABAAAADAAAACAAAAAAAAAABBAAAAAADAAAAAAABAAAAAABAAAABAAAAAAAACAAAAAAAAABAAAAAAAAAAABBAAAAAAAAAAABAAAAAAAAACAAAAAAAABAAAAAAAAAADAAAAABAAAAAAAAABAAAAAAAAAAAAAAAAAAABAAAAAAAADAAB
BAAAAABBAAAAAAAAAAAAAABBBACAAAAAAABAAAAAAAAAAAAACABAAAAAAAAAAAABAAAAAAAAAADAAAAACAAABABAAABAAAAAAABAAAAAAAAABAAABBAAAAAAAAAAABAAAAAAAAAAAAAAAAAABAAAAAACAAAAAAAAABAAAAAAAAAAAAAAABAAAA
AAAEAAAAABAAAAAABAAAAAAAAAAAABAAAAAAACABAAAAAAAAAAAAAAAABAABBBAAAAAAAABAAAAAAAAAAAAAAAAABAAABAAAAAACAAAAAAAAAAAAAAAAAABAAAAADAAAAAAAAAABAAAAAAAAAAAAAAAAAAAABAAAAAAAAAAAAAAAAABAAAAAAA
ABAAAAAAAAABAAAAAAAAAABAAACAAAAAAAAAAAAABAAADAAAAAABAAAAAAAAAAAACAAAAAAADAAAAAAAAABAACAAAAAAAAAAAABAAAAAAAAAABAAAAAAAAAAAAAAAAAAAABAAAAAAAAABBBAAAAABAAAAAAAAAAAAAABAAAAAAAAAAAAAAAAAA
DAAAAAABACAAAAAABAAAAAAABAAAAAAACAAAABAAAAABAAAABAAAAACAAAAAAAABAABAAAAAAAAAAABAAAAAAAAABAAAAADAAAAAAAAAAAACAAAAAABAAAAAAAABAAAAAAAAAAAACAAAAABAAAAAAAAAAADAAAAAABAAAAAAAABBAAAABABAAB
